6 6
1 2 3 4 5 6
8 9 1 2 3 4
7 6 5 4 4 5
5 4 8 3 2 1
9 8 3 5 4 2
1 3 5 2 9 6